1111111111111111111111111111111111111111111111111111
1111000P00000000000000000000000000000000000000000001
10000000000000XC111111111100000000000000000000000001
1000000000000X0000000000000000000X000000000111111111
10000000000111111111111000000000000000X0001111000001
1000000000111111000000000000000000000000001100000001
1000000000000000001111111111111111000000001111000001
1000000000000000000000C10000000010000000000111100001
1011111000000000000000001100000000C000000000X0000001
100001X00000000000000001000000000100000000000X000001
10C1111000000000000000010C000X1111111111111111111111
100000000111111111111111111111000000000000X000000001
100000000000000000000000000X100000000000000000000001
100000000000001001X10000001EX00000000000X00000000001
100000000000000000000000000C100000000000000000000001
1111111111111111111111111111111111111111111111111111